...........................................................................................................................................................................................................................................................................................................
...........................................................................................................................................................................................................................................................................................................
...........................................................................................................................................................................................................................................................................................................
...........................................................................................................................................................................................................................................................................................................
....P......................................................................................................................................................................................................................................................................................................
.......................................................................G...............................................................W...................................................................................................................................................................
....................GGGGGGGGG.........O....O.............GGGGGGGGGGGGGGG.OOOO.............GGGGGGGGGGGGGGGGGGGG.........................|...................................................................................................................................................................
TTTTTTTTTTTTTTTTTTTTTTTTTTTTT000TTTTTTTTTTTTTTTTTTTTTTTTTTTTTTTTTTTTTTTTTTTTTTTTTTTTTTTTTTTTTTTTTTTTTTTTTTTTTTTTTTTTTTTTTTTTTTTTTTTTTTTTTTTTTTTTTTTTTTTTTTTTTTTTTTTTTTTTTTTTTTTTTTTTTTTTTTTTTTTTTTTTTTTTTTTTTTTTTTTTTTTTTTTTTTTTTT00000000000000000000000000000TTTTTTTTTTTTTTTTTTTTTTTTTTTTTTTTTTTTTTTTTTTT
00000000000000000000000000000000000000000000000000000000000000000000000000000000000000000000000000000000000000000000000000000000000000000000000000000000000000000000000000000000000000000000000000000000000000000000000000000000000000000000000000000000000000000000000000000000000000000000000000000000000
00000000000000000000000000000000000000000000000000000000000000000000000000000000000000000000000000000000000000000000000000000000000000000000000000000000000000000000000000000000000000000000000000000000000000000000000000000000000000000000000000000000000000000000000000000000000000000000000000000000000