...........................................................................................................................................................................................................................................................................................................
..........................................................................................................G........................................................................................................................................................G.......................................
..........................................................................................................V.........................................................................................O..............................................................V..............G........................
...................................................................._____________................................................................................................................GGGGGGGG.....................................___.........G............O..........V........................
.........................................._...................................................G......................................................_......................................G..............G.............................OO...........J..........GGGGGGGG..................................
............P........................_........................................................G...........................G____.........................................____...........G......................G...................tTTTTTTTTTTTTTTTTTTTTTTTTTTTy..........................W.................
...................O.........tTy......OOOOOOOO...........O.....O.......J.....J...........J....G......J................____G...........OO.......J...OOOOO..........JOOOOOOOOOOOOOOOG......OOOOOOOOOOOOOOO..OOOOOO........O.......J.e000000000000000000000000000dOOOOOOOOOOO........G......|.................
TTTTTTTTTTTTTTTTTTTTTTTTTTTTT000TTTTTTTTTTTTTTTTTTTTTTTTTTTTTTTTTTTTTTTTTTTTTTTTTTTTTTTTTTTTTTTTTTTTTTTTTTTTTTTTTTTTTTTTTTTTTTTTTTTTTTTTTTTTTTTTTTTTTTTTTTTTTTTTTTTTTTTTTTTTTTTTTTTTTTTTTTTTTTTTTTTTTTTTTTTTTTTTTTTTTTTTTTTTTTTTTT00000000000000000000000000000TTTTTTTTTTTTTTTTTTTTTTTTTTTTTTTTTTTTTTTTTTTT
00000000000000000000000000000000000000000000000000000000000000000000000000000000000000000000000000000000000000000000000000000000000000000000000000000000000000000000000000000000000000000000000000000000000000000000000000000000000000000000000000000000000000000000000000000000000000000000000000000000000
00000000000000000000000000000000000000000000000000000000000000000000000000000000000000000000000000000000000000000000000000000000000000000000000000000000000000000000000000000000000000000000000000000000000000000000000000000000000000000000000000000000000000000000000000000000000000000000000000000000000